NO textures/no.xpm
SO textures/so.xpm
WE textures/we.xpm
EA textures/ea.xpm
F 64, 64, 64
C 135, 206, 235

           1111111111111
        1111000000000001111
       110000000000000000011
      11000000000000000000011
    111000000000000000000000111
    100000000000000000000000001
   11000000000000000000000000011
  1100000000000000000000000000011
 110000000000000000000000000000011
 100000000000000000000000000000001
 100000000000000000000000000000001
11000000000000000000000000000000011
10000000000000000000000000000000001
10000000000000000000000000000000001
10000000000000000000000000000000001
10000000000000000000000000000000001
10000000000000000000000000000000001
10000000000000000N00000000000000001
10000000000000000000000000000000001
10000000000000000000000000000000001
10000000000000000000000000000000001
10000000000000000000000000000000001
10000000000000000000000000000000001
11000000000000000000000000000000011
 100000000000000000000000000000001
 100000000000000000000000000000001
 110000000000000000000000000000011
  1100000000000000000000000000011
   11000000000000000000000000011
    100000000000000000000000001
    111000000000000000000000111
      11000000000000000000011
       110000000000000000011
        1111000000000001111
           1111111111111
