NO textures/wood.xpm

C   0 , 0, 0
SO   textures/colorstone.xpm
WE textures/colorstone.xpm
EA textures/colorstone.xpm
F 90 , 90, 90

        1111111111111111111111111
        1000000000110000000000001
        101100000111D000000000001111
        100100000000D000000000001
11111111101100000111D000000000001
10000000001100000111D111111111111
11110111111111011100000010001
11110111111111011101010010001
110000001101010111000000D0001
10000000000000001100000010001
10000000000000001101010010001
1100000111010101111101111N0111
11110111 1110101 101111010001
11111111 1111111 111111111111