NO textures/no.xpm

C      1,1,1
SO   textures/so.xpm
WE textures/we.xpm
EA                                                         textures/ea.xpm
F             220,    100       ,               0


11111111111111111111111
10000000000000000000001
100001010101000111110N1
11111111111111111111111